敌空空空空空敌空空空空空敌
空空空空空铁铁空空空空空空
空水水水水水铁水水水水水空
空铁铁草草砖铁砖草草铁铁空
空空空铁草草铁草草铁空空空
草空空空铁草草草铁空空空草
铁草水水水草草草水水水草铁
草草草草草砖草砖草空空空草
空砖空砖空砖空砖空砖空砖空
空砖空砖空砖空砖空砖空砖空
空砖空砖空空铁空空砖空砖空
空空空空空空空空空空空空空
空空铁空空空空空空我铁空空